0000000000000
00010000000C0
0000111110010
0P0011E000000
0000000000000