1111111111111111111
100000000P000000001
1000000000000000001
10000000000000P0001
1000000000000000001
1000000000000000001
10C00C00E0000000001
1111111111111111111
