1111111111
1000000001
10000C0001
1000000001
100P000001
1000000001
100C000001
1000000001
10C00E0001
1111111111
