1111111111111111111111111111
1000000000000000000000000001
1000000000000C00000000000001
1000000000000000000000000001
10000000C0000100000000000001
1000000000001PE0000000000001
1000000000000100000000000001
1000C00000000000000000000001
1111111111111111111111111111
