1111111111111
1000000000001
1000000000001
1E00000000001
10C000P000001
1000000000001
1000000000001
1111111111111