11111111111111111111
11011100111100C11111
1101010C111100111111
1000000110C0000C0011
10000000000000000011
100000000000C0000111
1000C110111000000011
111111101110110C1111
11110000111001101111
11110000000111111111
110111P0111100C11111
1101010C111100111111
1000000110C0000C0011
10000000000000000011
100000000000C0000111
1000C110111000000011
111111101110110C1111
111100001110E1101111
11111111111111111111
