1111111111111111111
111100000000000P0011
100000000000000C0011
1000000000000C0000110
1E000000000000000011
1111111111111111111
