1111111111111111111
111100000000000P001
100000000000000C001
1000000000000C00001
1E00000000000000001
1111111111111111111
  1 1  111111111
		0001
