1111111111111111111
11100000000000P0011
100000000000000C001
1000000000000C00001
1E00000000000000001
11111111111111111111