1111111111111111
1111111111111111
1111111111111111
1000000000000001
1000000000000P01
10000000C0000001
1111111111111111
