11111
11111
1P011
1E0i1
1C011
11111
